1111111111111
1E0C001000011
11101100000P1
1000000010001
1111111111111